"a" = (/turf/simulated/wall/r_wall/gray/bunker,/area/map_template/complex/bunker)
"b" = (/turf/simulated/floor/exoplanet/concrete,/area/map_template/complex/bunker)
"c" = (/obj/machinery/light/complex{icon_state = "tube_map"; dir = 1},/turf/simulated/floor/exoplanet/concrete,/area/map_template/complex/bunker)
"d" = (/obj/machinery/light/complex,/turf/simulated/floor/exoplanet/concrete,/area/map_template/complex/bunker)
"e" = (/obj/landmark/map_load_mark/complex/bunker/north,/turf/simulated/floor/exoplanet/concrete,/area/map_template/complex/bunker)
"f" = (/obj/landmark/map_load_mark/complex/bunker/west,/turf/simulated/floor/exoplanet/concrete,/area/map_template/complex/bunker)
"g" = (/obj/landmark/map_load_mark/complex/bunker/south,/turf/simulated/floor/exoplanet/concrete,/area/map_template/complex/bunker)

(1,1,1) = {"
aaeaaaaaa
abbbbbcbb
fbbbbbbbb
abbdbbbbb
aagaaaaaa
"}
