"a" = (/turf/space,/area/space)
"b" = (/turf/simulated/wall/r_wall/gray/bunker,/area/map_template/complex/bunker)
"c" = (/turf/simulated/floor/exoplanet/concrete,/area/map_template/complex/bunker)
"d" = (/obj/machinery/light/complex{icon_state = "tube_map"; dir = 1},/turf/simulated/floor/exoplanet/concrete,/area/map_template/complex/bunker)
"e" = (/obj/machinery/light/complex{icon_state = "tube_map"; dir = 8},/turf/simulated/floor/exoplanet/concrete,/area/map_template/complex/bunker)
"f" = (/obj/landmark/map_load_mark/complex/bunker/east,/turf/simulated/floor/exoplanet/concrete,/area/map_template/complex/bunker)

(1,1,1) = {"
bbbbbbbbb
bccccdccb
bcccccccf
bcccccccb
bcccbbbbb
beccbaaaa
bcccbaaaa
bcccbaaaa
"}
