"a" = (/turf/simulated/wall/r_wall/gray/bunker,/area/map_template/complex/bunker)
"b" = (/obj/landmark/map_load_mark/complex/bunker/north,/turf/simulated/floor/exoplanet/concrete/bunker,/area/map_template/complex/bunker)
"c" = (/turf/simulated/floor/exoplanet/concrete/bunker,/area/map_template/complex/bunker)
"d" = (/turf/template_noop,/area/map_template/complex/bunker)

(1,1,1) = {"
aabaa
accca
accca
accca
accca
accca
accca
accca
accca
accca
accca
aadaa
"}
