"a" = (/turf/simulated/wall/r_wall/gray/bunker,/area/map_template/complex/bunker)
"b" = (/obj/landmark/map_load_mark/complex/bunker/north,/turf/simulated/floor/exoplanet/concrete,/area/map_template/complex/bunker)
"c" = (/turf/simulated/floor/exoplanet/concrete,/area/map_template/complex/bunker)
"e" = (/obj/machinery/light/complex{icon_state = "tube_map"; dir = 8},/turf/simulated/floor/exoplanet/concrete,/area/map_template/complex/bunker)
"f" = (/obj/machinery/light/complex{icon_state = "tube_map"; dir = 4},/turf/simulated/floor/exoplanet/concrete,/area/map_template/complex/bunker)

(1,1,1) = {"
aabaa
accca
accca
accca
aecca
accca
accca
accca
accfa
accca
accca
accca
"}
