"a" = (/turf/template_noop,/area/template_noop)
"b" = (/turf/simulated/floor/exoplanet/concrete,/area/map_template/complex/bunker)
"c" = (/turf/simulated/floor/exoplanet/concrete/reinforced,/area/map_template/complex/bunker)
"d" = (/turf/unsimulated/floor/plating,/area/map_template/complex/bunker)

(1,1,1) = {"
aabbbaa
abcccba
bcccccb
bccdccb
bcccccb
abcccba
aabbbaa
"}
