"a" = (/turf/simulated/wall/r_wall/gray/bunker,/area/map_template/complex/bunker)
"b" = (/obj/structure/catwalk,/turf/simulated/floor/exoplanet/plating,/area/map_template/complex/bunker)
"c" = (/obj/landmark/map_load_mark/complex/bunker/mark_for_marks,/obj/structure/catwalk,/turf/simulated/floor/exoplanet/plating,/area/map_template/complex/bunker)
"d" = (/obj/structure/catwalk,/obj/machinery/light/complex{icon_state = "tube_map"; dir = 1},/turf/simulated/floor/exoplanet/plating,/area/map_template/complex/bunker)
"e" = (/obj/landmark/map_data{height = 2},/turf/simulated/wall/r_wall/gray/bunker,/area/map_template/complex/bunker)
"f" = (/obj/structure/catwalk,/obj/machinery/light/complex,/turf/simulated/floor/exoplanet/plating,/area/map_template/complex/bunker)

(1,1,1) = {"
aabaaa
abbbda
abbbba
abbcbb
abbbba
abbbfa
eabaaa
"}
